13 13 13 13 13 13 13 13 13 13 13 13 13 13 13 13 13 13 13 13 13 13 13 13 13 13 13 13 13 13 13 13 13 13 13 13 13 13 13 13 13 13 13 13 13 13 13 13 13 13
13 13 13 13 13 13 13 13 13 13 13 13 13 13 13 13 13 13 13 13 13 13 13 13 13 13 13 13 13 13 13 13 13 13 13 13 13 13 13 13 13 13 13 13 13 13 13 13 13 13
13 13 13 13 13 13 13 13 13 13 13 13 13 13 13 13 13 13 13 13 13 13 13 13 13 13 13 13 13 13 13 13 13 13 13 13 13 13 13 13 13 13 13 13 13 13 13 13 13 13
13 13 13 13 13 13 13 13 13 13 13 13 13 13 13 13 13 13 13 13 13 13 13 13 13 13 13 13 13 13 13 13 13 13 13 13 13 13 13 13 13 13 13 13 13 13 13 13 13 13
13 13 13 13 13 13 13 13 13 13 13 13 13 13 13 13 13 13 13 13 13 13 13 13 13 13 13 13 13 13 13 13 13 13 13 13 13 13 13 13 13 13 13 13 13 13 13 13 13 13
13 13 13 13 13 13 13 13 13 13 13 13 13 13 13 13 13 13 13 13 13 13 13 13 13 13 13 13 13 13 13 13 13 13 13 13 13 13 13 13 13 13 13 13 13 13 13 13 13 13
13 13 13 13 13 13 13 13 13 13 22 22 22 22 22 22 22 22 22 22 22 22 22 22 22 22 22 22 22 22 22 22 22 22 22 22 22 22 22 22 13 13 13 13 13 13 13 13 13 13
13 13 13 13 13 13 13 13 13 13 22 22 22 22 22 22 22 22 22 22 22 22 22 22 22 22 22 22 22 22 22 22 22 22 22 22 22 22 22 22 13 13 13 13 13 13 13 13 13 13
13 13 13 13 13 13 13 13 13 13 22 22 22 22 22 22 22 22 22 22 22 22 22 22 22 22 22 22 22 22 22 22 22 22 22 22 22 22 22 22 13 13 13 13 13 13 13 13 13 13
13 13 13 13 13 13 13 13 13 13 22 22 22 22 22 22 22 22 22 22 22 22 22 22 22 22 22 22 22 22 22 22 22 22 22 22 22 22 22 22 13 13 13 13 13 13 13 13 13 13
13 13 13 13 13 13 13 13 13 13 22 22 22 22 22 22 22 22 22 22 22 22 22 22 22 22 22 22 22 22 22 22 22 22 22 22 22 22 22 22 13 13 13 13 13 13 13 13 13 13
13 13 13 13 13 13 13 13 13 13 22 22 22 22 22 22 22 22 22 22 22 22 22 22 22 22 22 22 22 22 22 22 22 22 22 22 22 22 22 22 13 13 13 13 13 13 13 13 13 13
13 13 13 13 13 13 13 13 13 13 22 22 22 22 22 22 22 22 22 22 22 22 22 22 22 22 22 22 22 22 22 22 22 22 22 22 22 22 22 22 13 13 13 13 13 13 13 13 13 13
13 13 13 13 13 13 13 13 13 13 22 22 22 22 22 22 22 22 22 22 22 22 22 22 22 22 22 22 22 22 22 22 22 22 22 22 22 22 22 22 13 13 13 13 13 13 13 13 13 13
13 13 13 13 13 13 13 13 13 13 22 22 22 22 22 22 22 22 22 22 22 22 22 22 22 22 22 22 22 22 22 22 22 22 22 22 22 22 22 22 13 13 13 13 13 13 13 13 13 13
13 13 13 13 13 13 13 13 13 13 22 22 22 22 22 22 22 22 22 22 22 22 22 22 22 22 22 22 22 22 22 22 22 22 22 22 22 22 22 22 13 13 13 13 13 13 13 13 13 13
13 13 13 13 13 13 13 13 13 13 22 22 22 22 22 22 22 22 22 22 22 22 22 22 22 22 22 22 22 22 22 22 22 22 22 22 22 22 22 22 13 13 13 13 13 13 13 13 13 13
13 13 13 13 13 13 13 13 13 13 22 22 22 22 22 22 22 22 22 22 22 22 22 22 22 22 22 22 22 22 22 22 22 22 22 22 22 22 22 22 13 13 13 13 13 13 13 13 13 13
13 13 13 13 13 13 13 13 13 13 22 22 22 22 22 22 22 22 22 14 15 15 15 15 15 15 15 15 15 15 15 16 22 22 22 22 22 22 22 22 13 13 13 13 13 13 13 13 13 13
13 13 13 13 13 13 13 13 13 13 22 22 22 22 22 22 22 22 22 17 22 22 22 22 22 22 22 22 22 22 22 18 22 22 22 22 22 22 22 22 13 13 13 13 13 13 13 13 13 13
13 13 13 13 13 13 13 13 13 13 22 22 22 22 22 22 22 22 22 17 22 22 22 22 22 22 22 22 22 22 22 18 22 22 22 22 22 22 22 22 13 13 13 13 13 13 13 13 13 13
13 13 13 13 13 13 13 13 13 13 22 22 22 22 22 22 22 22 22 17 22 22 22 22 22 22 22 22 22 22 22 18 22 22 22 22 22 22 22 22 13 13 13 13 13 13 13 13 13 13
13 13 13 13 13 13 13 13 13 13 22 22 22 22 22 22 22 22 22 17 22 22 22 22 22 22 22 22 22 22 22 18 22 22 22 22 22 22 22 22 13 13 13 13 13 13 13 13 13 13
13 13 13 13 13 13 13 13 13 13 22 22 22 22 22 22 22 22 22 17 22 22 22 22 22 22 22 22 22 22 22 18 22 22 22 22 22 22 22 22 13 13 13 13 13 13 13 13 13 13
13 13 13 13 13 13 13 13 13 13 22 22 22 22 22 22 22 22 22 17 22 22 22 22 22 22 22 22 22 22 22 18 22 22 22 22 22 22 22 22 13 13 13 13 13 13 13 13 13 13
13 13 13 13 13 13 13 13 13 13 22 22 22 22 22 22 22 22 22 17 22 22 22 22 22 22 22 22 22 22 22 18 22 22 22 22 22 22 22 22 13 13 13 13 13 13 13 13 13 13
13 13 13 13 13 13 13 13 13 13 22 22 22 22 22 22 22 22 22 17 22 22 22 22 22 22 22 22 22 22 22 18 22 22 22 22 22 22 22 22 13 13 13 13 13 13 13 13 13 13
13 13 13 13 13 13 13 13 13 13 22 22 22 22 22 22 22 22 22 17 22 22 22 22 22 22 22 22 22 22 22 18 22 22 22 22 22 22 22 22 13 13 13 13 13 13 13 13 13 13
13 13 13 13 13 13 13 13 13 13 22 22 22 22 22 22 22 22 22 17 22 22 22 22 22 22 22 22 22 22 22 18 22 22 22 22 22 22 22 22 13 13 13 13 13 13 13 13 13 13
13 13 13 13 13 13 13 13 13 13 22 22 22 22 22 22 22 22 22 17 22 22 22 22 22 22 22 22 22 22 22 18 22 22 22 22 22 22 22 22 13 13 13 13 13 13 13 13 13 13
13 13 13 13 13 13 13 13 13 13 22 22 22 22 22 22 22 22 22 19 20 20 20 20 20 22 20 20 20 20 20 21 22 22 22 22 22 22 22 22 13 13 13 13 13 13 13 13 13 13
13 13 13 13 13 13 13 13 13 13 22 22 22 22 22 22 22 22 22 22 22 22 22 22 22 22 22 22 22 22 22 22 22 22 22 22 22 22 22 22 13 13 13 13 13 13 13 13 13 13
13 13 13 13 13 13 13 13 13 13 22 22 22 22 22 22 22 22 22 22 22 22 22 22 22 22 22 22 22 22 22 22 22 22 22 22 22 22 22 22 13 13 13 13 13 13 13 13 13 13
13 13 13 13 13 13 13 13 13 13 22 22 22 22 22 22 22 22 22 22 22 22 22 22 22 22 22 22 22 22 22 22 22 22 22 22 22 22 22 22 13 13 13 13 13 13 13 13 13 13
13 13 13 13 13 13 13 13 13 13 22 22 22 14 15 15 15 14 22 22 22 22 22 22 22 22 22 22 22 22 22 22 14 15 15 15 16 22 22 22 13 13 13 13 13 13 13 13 13 13
13 13 13 13 13 13 13 13 13 13 22 22 22 17 22 22 22 18 22 22 22 22 22 22 22 22 22 22 22 22 22 22 17 22 22 22 18 22 22 22 13 13 13 13 13 13 13 13 13 13
13 13 13 13 13 13 13 13 13 13 22 22 22 17 22 22 22 18 22 22 22 22 22 22 22 22 22 22 22 22 22 22 17 22 22 22 18 22 22 22 13 13 13 13 13 13 13 13 13 13
13 13 13 13 13 13 13 13 13 13 22 22 22 17 22 22 22 18 22 22 22 22 22 22 22 22 22 22 22 22 22 22 17 22 22 22 18 22 22 22 13 13 13 13 13 13 13 13 13 13
13 13 13 13 13 13 13 13 13 13 22 22 22 17 22 22 22 18 22 22 22 22 22 22 22 22 22 22 22 22 22 22 17 22 22 22 18 22 22 22 13 13 13 13 13 13 13 13 13 13
13 13 13 13 13 13 13 13 13 13 22 22 22 17 22 22 22 18 22 22 22 22 22 22 22 22 22 22 22 22 22 22 17 22 22 22 18 22 22 22 13 13 13 13 13 13 13 13 13 13
13 13 13 13 13 13 13 13 13 13 22 22 22 17 22 22 22 18 22 22 22 22 22 22 22 22 22 22 22 22 22 22 17 22 22 22 18 22 22 22 13 13 13 13 13 13 13 13 13 13
13 13 13 13 13 13 13 13 13 13 22 22 22 19 20 22 20 21 22 22 22 22 22 22 22 22 22 22 22 22 22 22 19 20 22 20 21 22 22 22 13 13 13 13 13 13 13 13 13 13
13 13 13 13 13 13 13 13 13 13 22 22 22 22 22 22 22 22 22 22 22 22 22 22 22 22 22 22 22 22 22 22 22 22 22 22 22 22 22 22 13 13 13 13 13 13 13 13 13 13
13 13 13 13 13 13 13 13 13 13 22 22 22 22 22 22 22 22 22 22 22 22 22 22 22 22 22 22 22 22 22 22 22 22 22 22 22 22 22 22 13 13 13 13 13 13 13 13 13 13
13 13 13 13 13 13 13 13 13 13 13 13 13 13 13 13 13 13 13 13 13 13 13 13 13 13 13 13 13 13 13 13 13 13 13 13 13 13 13 13 13 13 13 13 13 13 13 13 13 13
13 13 13 13 13 13 13 13 13 13 13 13 13 13 13 13 13 13 13 13 13 13 13 13 13 13 13 13 13 13 13 13 13 13 13 13 13 13 13 13 13 13 13 13 13 13 13 13 13 13
13 13 13 13 13 13 13 13 13 13 13 13 13 13 13 13 13 13 13 13 13 13 13 13 13 13 13 13 13 13 13 13 13 13 13 13 13 13 13 13 13 13 13 13 13 13 13 13 13 13
13 13 13 13 13 13 13 13 13 13 13 13 13 13 13 13 13 13 13 13 13 13 13 13 13 13 13 13 13 13 13 13 13 13 13 13 13 13 13 13 13 13 13 13 13 13 13 13 13 13
13 13 13 13 13 13 13 13 13 13 13 13 13 13 13 13 13 13 13 13 13 13 13 13 13 13 13 13 13 13 13 13 13 13 13 13 13 13 13 13 13 13 13 13 13 13 13 13 13 13
13 13 13 13 13 13 13 13 13 13 13 13 13 13 13 13 13 13 13 13 13 13 13 13 13 13 13 13 13 13 13 13 13 13 13 13 13 13 13 13 13 13 13 13 13 13 13 13 13 13