1 1 1 1 1 1 1 1 1 1 1 1 1 1 1 1 1 1 1 1 1 1 1 1 1 1 1 1 1 1 1 1 1 1 1 1 1 1 1 1 1 1 1 1 1 1 1 1 1 1
1 1 1 1 1 1 1 1 1 1 1 1 1 1 1 1 1 1 1 1 1 1 1 1 1 1 1 1 1 1 1 1 1 1 1 1 1 1 1 1 1 1 1 1 1 1 1 1 1 1
1 1 1 1 1 1 1 1 1 1 1 1 1 1 1 1 1 1 1 1 1 1 1 1 1 1 1 1 1 1 1 1 1 1 1 1 1 1 1 1 1 1 1 1 1 1 1 1 1 1
1 1 1 1 1 1 1 1 1 1 1 1 1 1 1 1 1 1 1 1 1 1 1 1 1 1 1 1 1 1 1 1 1 1 1 1 1 1 1 1 1 1 1 1 1 1 1 1 1 1
1 1 1 1 1 1 1 1 1 1 1 1 1 1 1 1 1 1 1 1 1 1 1 1 1 1 1 1 1 1 1 1 1 1 1 1 1 1 1 1 1 1 1 1 1 1 1 1 1 1
1 1 1 1 1 1 1 1 1 1 1 1 1 1 1 1 1 1 1 1 1 1 1 1 1 1 1 1 1 1 1 1 1 1 1 1 1 1 1 1 1 1 1 1 1 1 1 1 1 1
1 1 1 1 1 1 1 1 1 1 0 0 0 0 0 0 0 0 0 0 0 0 0 0 0 0 0 0 0 0 0 0 0 0 0 0 0 0 0 0 1 1 1 1 1 1 1 1 1 1
1 1 1 1 1 1 1 1 1 1 0 2 5 5 5 5 5 5 5 5 5 5 5 5 5 5 5 5 5 5 5 5 5 5 5 5 5 5 6 0 1 1 1 1 1 1 1 1 1 1
1 1 1 1 1 1 1 1 1 1 0 3 0 0 0 0 0 0 0 0 0 0 10 3 0 0 0 0 0 0 0 0 0 0 0 0 0 0 7 0 1 1 1 1 1 1 1 1 1 1
1 1 1 1 1 1 1 1 1 1 0 0 0 2 5 5 5 5 5 0 2 5 5 5 5 5 5 5 6 0 2 5 5 5 5 5 5 5 7 0 1 1 1 1 1 1 1 1 1 1
1 1 1 1 1 1 1 1 1 1 0 3 0 3 0 0 0 0 0 0 3 0 0 0 0 0 0 0 7 0 3 0 0 0 0 0 0 0 7 0 1 1 1 1 1 1 1 1 1 1
1 1 1 1 1 1 1 1 1 1 0 3 0 4 9 9 9 9 9 0 3 0 0 0 0 0 0 0 7 0 3 0 2 5 5 5 6 0 7 0 1 1 1 1 1 1 1 1 1 1
1 1 1 1 1 1 1 1 1 1 0 3 0 0 0 0 0 0 0 0 3 0 0 0 0 0 0 0 0 0 3 0 3 0 0 0 7 0 7 0 1 1 1 1 1 1 1 1 1 1
1 1 1 1 1 1 1 1 1 1 0 3 0 2 5 5 5 6 0 0 3 0 0 0 0 0 0 0 7 0 3 0 3 0 2 5 8 0 7 0 1 1 1 1 1 1 1 1 1 1
1 1 1 1 1 1 1 1 1 1 0 3 0 3 0 0 0 7 0 0 4 9 9 9 9 9 9 9 8 0 3 0 0 0 3 0 0 0 7 0 1 1 1 1 1 1 1 1 1 1
1 1 1 1 1 1 1 1 1 1 0 3 0 3 0 0 0 7 0 0 0 0 0 0 0 0 0 0 0 0 4 9 9 0 4 9 9 9 7 0 1 1 1 1 1 1 1 1 1 1
1 1 1 1 1 1 1 1 1 1 0 3 0 3 0 0 0 7 0 0 2 5 5 5 5 5 5 5 6 0 0 0 0 0 0 0 0 0 7 0 1 1 1 1 1 1 1 1 1 1
1 1 1 1 1 1 1 1 1 1 0 3 0 3 0 0 0 7 0 0 0 0 0 0 0 0 0 0 7 0 2 5 5 5 5 5 5 5 7 0 1 1 1 1 1 1 1 1 1 1
1 1 1 1 1 1 1 1 1 1 0 3 0 3 0 0 0 7 9 9 9 9 9 9 9 0 9 9 7 0 3 0 0 0 0 0 0 0 7 0 1 1 1 1 1 1 1 1 1 1
1 1 1 1 1 1 1 1 1 1 0 3 0 4 9 0 9 8 0 0 0 0 0 0 0 0 0 0 7 0 3 0 0 0 0 0 0 0 7 0 1 1 1 1 1 1 1 1 1 1
1 1 1 1 1 1 1 1 1 1 0 3 0 0 0 0 0 0 0 2 5 5 5 5 5 0 2 5 8 0 3 0 0 0 0 0 0 0 7 0 1 1 1 1 1 1 1 1 1 1
1 1 1 1 1 1 1 1 1 1 0 3 0 2 5 5 5 5 5 8 0 0 0 0 0 0 7 0 0 0 0 0 0 0 0 0 0 0 7 0 1 1 1 1 1 1 1 1 1 1
1 1 1 1 1 1 1 1 1 1 0 3 0 3 0 0 0 0 0 0 0 0 2 5 5 5 6 0 3 0 3 0 0 0 0 0 0 0 7 0 1 1 1 1 1 1 1 1 1 1
1 1 1 1 1 1 1 1 1 1 0 3 0 3 0 2 5 5 5 5 5 5 3 0 10 0 7 0 3 0 3 0 0 0 0 0 0 0 7 0 1 1 1 1 1 1 1 1 1 1
1 1 1 1 1 1 1 1 1 1 0 3 0 3 0 3 0 0 0 0 0 0 3 0 0 0 7 0 3 0 3 5 5 5 5 5 5 5 7 0 1 1 1 1 1 1 1 1 1 1
1 1 1 1 1 1 1 1 1 1 0 3 0 3 0 3 0 0 0 0 0 0 3 0 0 0 7 0 3 0 3 0 0 0 0 0 0 0 7 0 1 1 1 1 1 1 1 1 1 1
1 1 1 1 1 1 1 1 1 1 0 3 0 3 0 3 0 0 0 0 0 0 3 0 0 0 7 0 3 0 0 0 0 0 0 0 0 0 7 0 1 1 1 1 1 1 1 1 1 1
1 1 1 1 1 1 1 1 1 1 0 3 0 3 0 3 0 0 0 0 0 0 4 6 0 2 8 0 3 0 3 0 0 0 0 0 0 0 7 0 1 1 1 1 1 1 1 1 1 1
1 1 1 1 1 1 1 1 1 1 0 3 0 3 0 3 0 0 0 0 0 0 0 3 0 7 0 0 3 0 3 0 0 0 0 0 0 0 7 0 1 1 1 1 1 1 1 1 1 1
1 1 1 1 1 1 1 1 1 1 0 3 0 3 0 4 9 9 0 9 9 9 9 3 0 7 0 0 3 9 4 9 9 9 9 9 9 9 7 0 1 1 1 1 1 1 1 1 1 1
1 1 1 1 1 1 1 1 1 1 0 3 0 3 0 0 0 0 0 0 0 0 0 3 0 7 0 0 3 0 0 0 0 0 0 0 0 0 7 0 1 1 1 1 1 1 1 1 1 1
1 1 1 1 1 1 1 1 1 1 0 3 0 4 9 9 9 9 9 9 9 9 9 3 0 7 0 0 3 0 5 5 5 5 5 6 0 0 7 0 1 1 1 1 1 1 1 1 1 1
1 1 1 1 1 1 1 1 1 1 0 3 0 0 0 0 0 0 0 0 0 0 0 3 0 7 0 0 0 0 0 0 0 0 0 7 0 0 7 0 1 1 1 1 1 1 1 1 1 1
1 1 1 1 1 1 1 1 1 1 0 3 0 2 5 5 5 5 5 5 5 6 0 3 0 4 9 9 9 9 9 9 9 9 9 9 9 9 7 0 1 1 1 1 1 1 1 1 1 1
1 1 1 1 1 1 1 1 1 1 0 3 0 3 0 0 0 10 0 0 0 7 0 3 0 0 0 0 0 0 0 0 0 0 0 0 0 0 7 0 1 1 1 1 1 1 1 1 1 1
1 1 1 1 1 1 1 1 1 1 0 3 0 3 0 0 0 0 0 0 0 7 0 4 9 9 9 9 9 9 9 9 9 9 9 9 6 0 7 0 1 1 1 1 1 1 1 1 1 1
1 1 1 1 1 1 1 1 1 1 0 3 0 3 0 0 0 0 0 0 0 7 0 0 0 0 0 0 0 0 0 0 0 0 0 0 7 0 7 0 1 1 1 1 1 1 1 1 1 1
1 1 1 1 1 1 1 1 1 1 0 3 0 3 0 0 0 0 0 0 0 7 0 2 5 5 5 5 5 5 5 5 5 5 5 0 7 0 7 0 1 1 1 1 1 1 1 1 1 1
1 1 1 1 1 1 1 1 1 1 0 3 0 4 9 9 6 0 9 9 9 8 0 3 0 0 0 0 0 0 0 0 0 0 0 0 7 0 7 0 1 1 1 1 1 1 1 1 1 1
1 1 1 1 1 1 1 1 1 1 0 3 0 0 0 0 7 0 0 0 0 0 0 3 0 2 5 5 5 5 5 6 0 2 9 9 8 0 7 0 1 1 1 1 1 1 1 1 1 1
1 1 1 1 1 1 1 1 1 1 0 3 0 0 0 0 7 0 5 5 5 5 5 3 0 3 0 0 0 0 0 7 0 3 0 0 0 0 7 0 1 1 1 1 1 1 1 1 1 1
1 1 1 1 1 1 1 1 1 1 0 3 0 0 0 0 7 0 0 0 0 0 0 3 0 0 0 0 0 0 0 7 0 3 0 0 0 0 7 0 1 1 1 1 1 1 1 1 1 1
1 1 1 1 1 1 1 1 1 1 0 4 9 9 9 9 9 9 9 9 9 9 9 9 9 9 9 9 9 9 9 9 9 9 9 9 9 9 7 0 1 1 1 1 1 1 1 1 1 1
1 1 1 1 1 1 1 1 1 1 0 0 0 0 0 0 0 0 0 0 0 0 0 0 0 0 0 0 0 0 0 0 0 0 0 0 0 0 0 0 1 1 1 1 1 1 1 1 1 1
1 1 1 1 1 1 1 1 1 1 1 1 1 1 1 1 1 1 1 1 1 1 1 1 1 1 1 1 1 1 1 1 1 1 1 1 1 1 1 1 1 1 1 1 1 1 1 1 1 1
1 1 1 1 1 1 1 1 1 1 1 1 1 1 1 1 1 1 1 1 1 1 1 1 1 1 1 1 1 1 1 1 1 1 1 1 1 1 1 1 1 1 1 1 1 1 1 1 1 1
1 1 1 1 1 1 1 1 1 1 1 1 1 1 1 1 1 1 1 1 1 1 1 1 1 1 1 1 1 1 1 1 1 1 1 1 1 1 1 1 1 1 1 1 1 1 1 1 1 1
1 1 1 1 1 1 1 1 1 1 1 1 1 1 1 1 1 1 1 1 1 1 1 1 1 1 1 1 1 1 1 1 1 1 1 1 1 1 1 1 1 1 1 1 1 1 1 1 1 1
1 1 1 1 1 1 1 1 1 1 1 1 1 1 1 1 1 1 1 1 1 1 1 1 1 1 1 1 1 1 1 1 1 1 1 1 1 1 1 1 1 1 1 1 1 1 1 1 1 1
1 1 1 1 1 1 1 1 1 1 1 1 1 1 1 1 1 1 1 1 1 1 1 1 1 1 1 1 1 1 1 1 1 1 1 1 1 1 1 1 1 1 1 1 1 1 1 1 1 1