13 13 13 13 13 13 13 13 13 13 13 13 13 13 13 13 13 13 13 13 13 13 13 13 13 13 13 13 13 13 13 13 13 13 13 13 13 13 13 13 13 13 13 13 13 13 13 13 13 13
13 13 13 13 13 13 13 13 13 13 13 13 13 13 13 13 13 13 13 13 13 13 13 13 13 13 13 13 13 13 13 13 13 13 13 13 13 13 13 13 13 13 13 13 13 13 13 13 13 13
13 13 13 13 13 13 13 13 13 13 13 13 13 13 13 13 13 13 13 13 13 13 13 13 13 13 13 13 13 13 13 13 13 13 13 13 13 13 13 13 13 13 13 13 13 13 13 13 13 13
13 13 13 13 13 13 13 13 13 13 13 13 13 13 13 13 13 13 13 13 13 13 13 13 13 13 13 13 13 13 13 13 13 13 13 13 13 13 13 13 13 13 13 13 13 13 13 13 13 13
13 13 13 13 13 13 13 13 13 13 13 13 13 13 13 13 13 13 13 13 13 13 13 13 13 13 13 13 13 13 13 13 13 13 13 13 13 13 13 13 13 13 13 13 13 13 13 13 13 13
13 13 13 13 13 13 13 13 13 13 13 13 13 13 13 13 13 13 13 13 13 13 13 13 13 13 13 13 13 13 13 13 13 13 13 13 13 13 13 13 13 13 13 13 13 13 13 13 13 13
13 13 13 13 13 13 13 13 13 13 22 22 22 22 22 22 22 22 22 22 22 22 22 22 22 22 22 22 22 22 22 22 22 22 22 22 22 22 22 22 13 13 13 13 13 13 13 13 13 13
13 13 13 13 13 13 13 13 13 13 22 22 22 22 22 22 22 22 22 23 22 22 22 22 22 22 22 22 22 22 22 22 22 22 22 22 22 23 22 22 13 13 13 13 13 13 13 13 13 13
13 13 13 13 13 13 13 13 13 13 22 22 22 22 22 22 22 22 22 22 22 22 22 22 22 22 22 22 22 22 22 22 23 22 22 22 22 22 22 22 13 13 13 13 13 13 13 13 13 13
13 13 13 13 13 13 13 13 13 13 22 22 23 22 22 22 22 22 22 22 22 22 22 22 22 22 22 23 22 22 22 22 22 22 22 22 22 22 22 22 13 13 13 13 13 13 13 13 13 13
13 13 13 13 13 13 13 13 13 13 22 22 22 22 22 22 22 22 22 22 22 22 22 22 22 22 22 22 22 22 22 22 22 22 22 22 22 22 22 22 13 13 13 13 13 13 13 13 13 13
13 13 13 13 13 13 13 13 13 13 22 22 22 22 22 22 22 22 22 22 22 22 22 22 22 22 22 22 22 22 22 22 22 22 22 23 22 22 22 22 13 13 13 13 13 13 13 13 13 13
13 13 13 13 13 13 13 13 13 13 22 22 22 22 22 22 22 22 22 22 22 22 22 22 22 22 22 22 22 22 22 22 22 22 22 22 22 22 22 22 13 13 13 13 13 13 13 13 13 13
13 13 13 13 13 13 13 13 13 13 22 22 22 22 22 22 22 22 22 22 23 22 22 22 22 22 22 22 22 22 22 22 22 22 22 22 22 22 22 22 13 13 13 13 13 13 13 13 13 13
13 13 13 13 13 13 13 13 13 13 22 22 22 22 22 22 22 22 22 22 22 22 22 22 22 22 22 23 22 22 22 22 22 22 22 22 22 22 22 22 13 13 13 13 13 13 13 13 13 13
13 13 13 13 13 13 13 13 13 13 22 23 22 22 22 22 22 22 22 22 22 22 22 22 22 22 22 22 22 22 22 22 22 22 22 22 22 22 22 22 13 13 13 13 13 13 13 13 13 13
13 13 13 13 13 13 13 13 13 13 22 22 22 22 22 22 22 22 22 22 22 22 22 22 22 22 22 22 22 22 22 22 22 22 22 23 22 22 22 22 13 13 13 13 13 13 13 13 13 13
13 13 13 13 13 13 13 13 13 13 22 22 22 22 22 22 23 22 22 22 22 22 22 22 22 22 22 22 22 22 22 22 22 22 22 22 22 22 22 22 13 13 13 13 13 13 13 13 13 13
13 13 13 13 13 13 13 13 13 13 22 22 22 22 22 22 22 22 22 14 15 15 15 15 15 15 15 15 15 15 15 16 22 22 22 22 22 22 22 22 13 13 13 13 13 13 13 13 13 13
13 13 13 13 13 13 13 13 13 13 22 22 22 22 22 22 22 22 22 17 24 24 24 24 24 24 24 24 24 24 24 18 22 22 22 22 22 22 22 22 13 13 13 13 13 13 13 13 13 13
13 13 13 13 13 13 13 13 13 13 22 22 22 22 22 22 22 22 22 17 24 24 24 24 24 24 24 24 24 24 24 18 23 22 22 22 22 22 22 22 13 13 13 13 13 13 13 13 13 13
13 13 13 13 13 13 13 13 13 13 22 22 22 23 22 22 22 22 22 17 24 24 24 24 24 24 24 24 24 24 24 18 22 22 22 22 22 22 22 22 13 13 13 13 13 13 13 13 13 13
13 13 13 13 13 13 13 13 13 13 22 22 22 22 22 22 22 22 22 17 24 24 24 24 24 24 24 24 24 24 24 18 22 22 22 22 22 23 22 22 13 13 13 13 13 13 13 13 13 13
13 13 13 13 13 13 13 13 13 13 22 22 22 22 22 22 22 22 22 17 24 24 24 24 24 24 24 24 24 24 24 18 22 22 22 22 22 22 22 22 13 13 13 13 13 13 13 13 13 13
13 13 13 13 13 13 13 13 13 13 22 22 22 22 22 22 22 22 22 17 24 24 24 24 24 24 24 24 24 24 24 18 22 22 22 22 22 22 22 22 13 13 13 13 13 13 13 13 13 13
13 13 13 13 13 13 13 13 13 13 22 22 22 22 22 22 22 22 22 17 24 24 24 24 24 24 24 24 24 24 24 18 22 23 22 22 22 22 22 22 13 13 13 13 13 13 13 13 13 13
13 13 13 13 13 13 13 13 13 13 22 22 22 22 22 22 22 22 22 17 24 24 24 24 24 24 24 24 24 24 24 18 22 22 22 22 22 22 22 22 13 13 13 13 13 13 13 13 13 13
13 13 13 13 13 13 13 13 13 13 22 23 22 22 22 22 22 22 22 17 24 24 24 24 24 24 24 24 24 24 24 18 22 22 22 22 22 22 22 22 13 13 13 13 13 13 13 13 13 13
13 13 13 13 13 13 13 13 13 13 22 22 22 22 22 22 22 22 22 17 24 24 24 24 24 24 24 24 24 24 24 18 22 22 22 22 22 23 22 22 13 13 13 13 13 13 13 13 13 13
13 13 13 13 13 13 13 13 13 13 22 22 22 22 22 22 23 22 22 17 24 24 24 24 24 24 24 24 24 24 24 18 22 22 22 22 22 22 22 22 13 13 13 13 13 13 13 13 13 13
13 13 13 13 13 13 13 13 13 13 22 22 22 22 22 22 22 22 22 19 20 20 20 20 20 24 20 20 20 20 20 21 22 23 22 22 22 22 22 22 13 13 13 13 13 13 13 13 13 13
13 13 13 13 13 13 13 13 13 13 22 22 22 22 22 22 22 22 22 22 22 22 22 22 22 22 22 22 22 22 22 22 22 22 22 22 22 22 22 22 13 13 13 13 13 13 13 13 13 13
13 13 13 13 13 13 13 13 13 13 22 22 22 22 22 22 22 22 22 22 22 22 22 22 22 22 22 22 22 22 22 22 22 22 22 22 22 22 22 22 13 13 13 13 13 13 13 13 13 13
13 13 13 13 13 13 13 13 13 13 22 22 22 22 22 22 22 22 22 22 22 22 22 23 22 22 22 22 22 23 22 22 22 22 22 22 22 22 22 22 13 13 13 13 13 13 13 13 13 13
13 13 13 13 13 13 13 13 13 13 22 22 22 14 15 15 15 16 22 23 22 22 22 22 22 22 22 22 22 22 22 22 14 15 15 15 16 22 22 22 13 13 13 13 13 13 13 13 13 13
13 13 13 13 13 13 13 13 13 13 22 23 22 17 25 25 25 18 22 22 22 22 22 22 22 22 22 22 22 22 22 22 17 25 25 25 18 22 22 22 13 13 13 13 13 13 13 13 13 13
13 13 13 13 13 13 13 13 13 13 22 22 22 17 25 25 25 18 22 22 22 22 22 22 22 22 22 22 22 22 22 22 17 25 25 25 18 22 22 22 13 13 13 13 13 13 13 13 13 13
13 13 13 13 13 13 13 13 13 13 22 22 22 17 25 25 25 18 22 22 22 22 22 22 22 23 22 22 22 22 22 22 17 25 25 25 18 22 22 22 13 13 13 13 13 13 13 13 13 13
13 13 13 13 13 13 13 13 13 13 22 22 22 17 25 25 25 18 22 22 22 22 22 22 22 22 22 22 22 22 22 22 17 25 25 25 18 22 23 22 13 13 13 13 13 13 13 13 13 13
13 13 13 13 13 13 13 13 13 13 22 22 22 17 25 25 25 18 22 22 22 22 22 22 22 22 22 22 22 22 22 22 17 25 25 25 18 22 22 22 13 13 13 13 13 13 13 13 13 13
13 13 13 13 13 13 13 13 13 13 22 22 22 17 25 25 25 18 22 22 22 22 22 22 22 22 22 22 22 22 22 22 17 25 25 25 18 22 22 22 13 13 13 13 13 13 13 13 13 13
13 13 13 13 13 13 13 13 13 13 22 22 22 19 20 25 20 21 22 22 23 22 22 22 22 22 22 22 23 22 22 22 19 20 25 20 21 22 22 22 13 13 13 13 13 13 13 13 13 13
13 13 13 13 13 13 13 13 13 13 22 23 22 22 22 22 22 22 22 22 22 22 22 22 22 22 22 22 22 22 22 22 22 22 22 22 22 22 22 22 13 13 13 13 13 13 13 13 13 13
13 13 13 13 13 13 13 13 13 13 22 22 22 22 22 22 22 22 22 22 22 22 22 22 22 22 22 22 22 22 22 22 22 22 22 22 22 22 22 22 13 13 13 13 13 13 13 13 13 13
13 13 13 13 13 13 13 13 13 13 13 13 13 13 13 13 13 13 13 13 13 13 13 13 13 13 13 13 13 13 13 13 13 13 13 13 13 13 13 13 13 13 13 13 13 13 13 13 13 13
13 13 13 13 13 13 13 13 13 13 13 13 13 13 13 13 13 13 13 13 13 13 13 13 13 13 13 13 13 13 13 13 13 13 13 13 13 13 13 13 13 13 13 13 13 13 13 13 13 13
13 13 13 13 13 13 13 13 13 13 13 13 13 13 13 13 13 13 13 13 13 13 13 13 13 13 13 13 13 13 13 13 13 13 13 13 13 13 13 13 13 13 13 13 13 13 13 13 13 13
13 13 13 13 13 13 13 13 13 13 13 13 13 13 13 13 13 13 13 13 13 13 13 13 13 13 13 13 13 13 13 13 13 13 13 13 13 13 13 13 13 13 13 13 13 13 13 13 13 13
13 13 13 13 13 13 13 13 13 13 13 13 13 13 13 13 13 13 13 13 13 13 13 13 13 13 13 13 13 13 13 13 13 13 13 13 13 13 13 13 13 13 13 13 13 13 13 13 13 13
13 13 13 13 13 13 13 13 13 13 13 13 13 13 13 13 13 13 13 13 13 13 13 13 13 13 13 13 13 13 13 13 13 13 13 13 13 13 13 13 13 13 13 13 13 13 13 13 13 13